********************
********************
*...s..............*
********************
....................
*.........*...**...*
*********...****.***
********************
********************
....................